1,January,2023,127738,32962,160700
2,February,2023,125834,36179,162013
3,March,2023,166149,52022,218171
4,April,2023,232663,123093,355756
5,May,2023,311327,196244,507571
6,June,2023,347312,247628,594940
7,July,2023,361789,273646,635435
8,August,2023,384918,259089,644007
9,September,2023,339834,218384,558218
10,October,2023,301170,146068,447238
11,November,2023,222636,81334,303970
12,December,2023,144199,41957,186156
